{
  "id": 4,
  "name": "Floor 4 - Management",
  "tileSize": 64,
  "cols": 26,
  "rows": 18,
  "tiles": [
    [1,1,1,1,1,1,1,1,1,1,1,1,1,1,1,1,1,1,1,1,1,1,1,1,1,1],
    [1,0,0,0,0,0,0,0,0,0,0,0,0,0,0,0,0,0,0,0,0,0,0,0,0,1],
    [1,0,2,2,0,0,0,0,0,0,0,1,1,1,0,0,0,0,0,0,2,2,0,0,0,1],
    [1,0,0,0,0,0,0,0,0,0,0,0,0,0,0,0,0,0,0,0,0,0,0,0,0,1],
    [1,0,0,0,0,1,0,0,0,0,0,0,0,0,0,0,0,0,0,1,0,0,0,0,0,1],
    [1,0,0,0,0,1,0,0,0,0,0,0,0,0,0,0,0,0,0,1,0,0,0,0,0,1],
    [1,0,0,0,0,0,0,0,0,0,0,0,0,0,0,0,0,0,0,0,0,0,0,0,0,1],
    [1,0,0,0,0,0,0,0,0,0,0,0,0,0,0,0,0,0,0,0,0,0,0,0,0,1],
    [1,1,1,1,0,0,0,0,0,0,0,0,0,0,0,0,0,0,0,0,0,0,1,1,1,1],
    [1,0,0,0,0,0,0,0,0,0,0,0,0,0,0,0,0,0,0,0,0,0,0,0,0,1],
    [1,0,0,0,0,0,0,0,0,0,0,0,0,0,0,0,0,0,0,0,0,0,0,0,0,1],
    [1,0,0,0,0,1,0,0,0,0,0,0,0,0,0,0,0,0,0,1,0,0,0,0,0,1],
    [1,0,0,0,0,1,0,0,0,0,0,0,0,0,0,0,0,0,0,1,0,0,0,0,0,1],
    [1,0,0,0,0,0,0,0,0,0,1,1,0,1,1,0,0,0,0,0,0,0,0,0,0,1],
    [1,0,2,2,0,0,0,0,0,0,0,0,0,0,0,0,0,0,0,0,2,2,0,0,0,1],
    [1,0,0,0,0,0,0,0,0,0,0,0,0,0,0,0,0,0,0,0,0,0,0,0,0,1],
    [1,0,0,0,0,0,0,0,0,0,0,0,0,0,0,0,0,0,0,0,0,0,0,0,0,1],
    [1,1,1,1,1,1,1,1,1,1,1,1,1,1,1,1,1,1,1,1,1,1,1,1,1,1]
  ],
  "playerStart": { "col": 2, "row": 2 },
  "elevator": { "col": 23, "row": 9 },
  "boss": { "col": 22, "row": 9 },
  "soldiers": [
    { "col": 9,  "row": 4 },
    { "col": 15, "row": 4 },
    { "col": 7,  "row": 13 },
    { "col": 17, "row": 13 },
    { "col": 12, "row": 7 },
    { "col": 12, "row": 11 }
  ],
  "innocents": [
    { "col": 4,  "row": 8 },
    { "col": 20, "row": 5 },
    { "col": 8,  "row": 15 },
    { "col": 16, "row": 2 }
  ],
  "pickups": [
    { "type": "health", "col": 3,  "row": 14 },
    { "type": "ammo",   "col": 13, "row": 2 },
    { "type": "armor",  "col": 21, "row": 14 },
    { "type": "ammo",   "col": 6,  "row": 8 }
  ]
}
