{
  "id": 3,
  "name": "Floor 3 - Accounts",
  "tileSize": 64,
  "cols": 24,
  "rows": 17,
  "tiles": [
    [1,1,1,1,1,1,1,1,1,1,1,1,1,1,1,1,1,1,1,1,1,1,1,1],
    [1,0,0,0,0,0,0,0,0,0,0,0,0,0,0,0,0,0,0,0,0,0,0,1],
    [1,0,2,2,0,0,0,0,0,0,0,0,0,0,0,0,0,0,2,2,0,0,0,1],
    [1,0,0,0,0,0,0,1,1,0,0,0,0,1,1,0,0,0,0,0,0,0,0,1],
    [1,0,0,0,0,0,0,0,0,0,0,0,0,0,0,0,0,0,0,0,0,0,0,1],
    [1,0,0,0,0,0,0,0,0,0,0,0,0,0,0,0,0,0,0,0,0,0,0,1],
    [1,0,0,0,2,0,0,0,0,0,0,0,0,0,0,0,0,0,0,2,0,0,0,1],
    [1,1,1,0,0,0,0,0,0,0,0,0,0,0,0,0,0,0,0,0,0,1,1,1],
    [1,0,0,0,0,0,0,0,0,0,0,0,0,0,0,0,0,0,0,0,0,0,0,1],
    [1,0,0,0,2,0,0,0,0,0,0,0,0,0,0,0,0,0,0,2,0,0,0,1],
    [1,0,0,0,0,0,0,0,0,0,1,1,1,0,0,0,0,0,0,0,0,0,0,1],
    [1,0,0,0,0,0,0,0,0,0,0,0,0,0,0,0,0,0,0,0,0,0,0,1],
    [1,0,0,0,0,0,0,1,1,0,0,0,0,1,1,0,0,0,0,0,0,0,0,1],
    [1,0,0,0,0,0,0,0,0,0,0,0,0,0,0,0,0,0,0,0,0,0,0,1],
    [1,0,2,2,0,0,0,0,0,0,0,0,0,0,0,0,0,0,2,2,0,0,0,1],
    [1,0,0,0,0,0,0,0,0,0,0,0,0,0,0,0,0,0,0,0,0,0,0,1],
    [1,1,1,1,1,1,1,1,1,1,1,1,1,1,1,1,1,1,1,1,1,1,1,1]
  ],
  "playerStart": { "col": 2, "row": 2 },
  "elevator": { "col": 21, "row": 8 },
  "boss": { "col": 20, "row": 8 },
  "soldiers": [
    { "col": 8,  "row": 3 },
    { "col": 14, "row": 3 },
    { "col": 6,  "row": 11 },
    { "col": 15, "row": 11 },
    { "col": 11, "row": 6 }
  ],
  "innocents": [
    { "col": 5,  "row": 5 },
    { "col": 17, "row": 13 },
    { "col": 10, "row": 12 }
  ],
  "pickups": [
    { "type": "health", "col": 3,  "row": 10 },
    { "type": "ammo",   "col": 11, "row": 15 },
    { "type": "armor",  "col": 20, "row": 3 },
    { "type": "life",   "col": 12, "row": 4 },
    { "type": "weapon", "weaponType": 4, "col": 19, "row": 14 }
  ]
}
