{
  "id": 2,
  "name": "Floor 2 - HR Department",
  "tileSize": 64,
  "cols": 22,
  "rows": 16,
  "tiles": [
    [1,1,1,1,1,1,1,1,1,1,1,1,1,1,1,1,1,1,1,1,1,1],
    [1,0,0,0,0,0,0,0,0,0,1,1,0,0,0,0,0,0,0,0,0,1],
    [1,0,2,2,0,0,0,0,0,0,0,0,0,0,0,0,2,2,0,0,0,1],
    [1,0,2,0,0,0,0,0,0,0,0,0,0,0,0,0,0,2,0,0,0,1],
    [1,0,0,0,0,1,1,0,0,0,0,0,0,0,1,1,0,0,0,0,0,1],
    [1,0,0,0,0,0,0,0,0,0,0,0,0,0,0,0,0,0,0,0,0,1],
    [1,1,1,0,0,0,0,0,0,0,0,0,0,0,0,0,0,0,0,1,1,1],
    [1,0,0,0,0,0,0,0,0,0,0,0,0,0,0,0,0,0,0,0,0,1],
    [1,0,0,0,0,0,0,0,0,0,0,0,0,0,0,0,0,0,0,0,0,1],
    [1,0,0,0,2,2,0,0,0,0,0,0,0,0,0,2,2,0,0,0,0,1],
    [1,0,0,0,2,0,0,0,0,0,0,0,0,0,0,0,2,0,0,0,0,1],
    [1,0,0,0,0,0,0,1,1,0,0,0,1,1,0,0,0,0,0,0,0,1],
    [1,0,0,0,0,0,0,0,0,0,0,0,0,0,0,0,0,0,0,0,0,1],
    [1,0,0,0,0,0,0,0,0,0,0,0,0,0,0,0,0,0,0,0,0,1],
    [1,0,0,0,0,0,0,0,0,0,0,0,0,0,0,0,0,0,0,0,0,1],
    [1,1,1,1,1,1,1,1,1,1,1,1,1,1,1,1,1,1,1,1,1,1]
  ],
  "playerStart": { "col": 2, "row": 2 },
  "elevator": { "col": 19, "row": 7 },
  "boss": { "col": 18, "row": 7 },
  "soldiers": [
    { "col": 7, "row": 4 },
    { "col": 12, "row": 4 },
    { "col": 6, "row": 10 },
    { "col": 14, "row": 10 }
  ],
  "innocents": [
    { "col": 9,  "row": 6 },
    { "col": 11, "row": 9 },
    { "col": 5,  "row": 12 }
  ],
  "pickups": [
    { "type": "health", "col": 4,  "row": 7 },
    { "type": "ammo",   "col": 10, "row": 2 },
    { "type": "armor",  "col": 17, "row": 13 },
    { "type": "weapon", "weaponType": 3, "col": 16, "row": 2 }
  ]
}
