{
  "id": 1,
  "name": "Ground Floor - Reception",
  "tileSize": 64,
  "cols": 20,
  "rows": 15,
  "tiles": [
    [1,1,1,1,1,1,1,1,1,1,1,1,1,1,1,1,1,1,1,1],
    [1,0,0,0,0,0,0,0,0,1,0,0,0,0,0,0,0,0,0,1],
    [1,0,0,2,2,0,0,0,0,1,0,0,0,0,0,0,2,2,0,1],
    [1,0,2,0,0,0,0,0,0,0,0,0,0,0,0,0,0,0,2,1],
    [1,0,2,0,0,0,0,0,0,0,0,0,0,0,0,0,0,0,2,1],
    [1,0,0,0,0,0,0,0,0,1,1,0,0,0,0,0,0,0,0,1],
    [1,0,0,0,0,0,0,0,0,0,0,0,0,0,0,0,0,0,0,1],
    [1,0,0,0,0,0,0,0,0,0,0,0,0,0,0,0,0,0,0,1],
    [1,0,0,0,0,0,0,0,0,0,0,0,0,0,0,0,0,0,0,1],
    [1,0,0,0,0,0,1,1,0,0,0,1,1,0,0,0,0,0,0,1],
    [1,0,0,2,0,0,0,0,0,0,0,0,0,0,0,2,0,0,0,1],
    [1,0,0,2,0,0,0,0,0,0,0,0,0,0,0,2,0,0,0,1],
    [1,0,0,0,0,0,0,0,0,0,0,0,0,0,0,0,0,0,0,1],
    [1,0,0,0,0,0,0,0,0,0,0,0,0,0,0,0,0,0,0,1],
    [1,1,1,1,1,1,1,1,1,1,1,1,1,1,1,1,1,1,1,1]
  ],
  "playerStart": { "col": 2, "row": 2 },
  "elevator": { "col": 17, "row": 7 },
  "boss": { "col": 16, "row": 7 },
  "soldiers": [
    { "col": 8, "row": 5 },
    { "col": 10, "row": 10 },
    { "col": 14, "row": 3 }
  ],
  "innocents": [
    { "col": 5, "row": 8 },
    { "col": 12, "row": 6 }
  ],
  "pickups": [
    { "type": "health", "col": 4, "row": 12 },
    { "type": "ammo",   "col": 7, "row": 2 },
    { "type": "weapon", "weaponType": 2, "col": 15, "row": 12 }
  ]
}
